#####################
# #         #       #
# ##### ##### ##### #
#     #     # #     #
##### # ### # # ### #
# #   # # #   # # # #
# # ### # ##### # # #
#   #     #   # # # #
# ######### # # # # #
#           #   #   #
#####################