#####################
# #   #             #
# # # # ########### #
#   # # #     # #   #
##### # # ### # # ###
#   #   # #     # # #
# # ##### ### ### # #
# # #       # #   # #
# # # ##### ### ### #
# #       #         #
#####################