#####################
# # #         #   # #
# # # ##### # # # # #
# #     #   # # # # #
# ####### ### # # # #
# #     # #     #   #
# # ### # ######### #
#   #   #       # # #
##### ######### # # #
#               #   #
#####################