#####################
#     #     #   #   #
##### # ### # # ### #
#   # #   #   # #   #
### # # # ##### # ###
#   # # # #   # #   #
# # # ### # ### # # #
# # #   # #   # # # #
# ##### # # # # ### #
#         # #       #
#####################