#####################
# #               # #
# ##### ### ##### # #
#     # #   #   # # #
##### # # ### ### # #
#   # # # #   #   # #
### # ### # # # ### #
#   #     # #   #   #
# ######### ##### # #
#                 # #
#####################