#########################################
# #           #   #       #         #   #
# # ######### # # ##### # # ####### # # #
#   #     # # # #     # #   #       # # #
####### # # # # ##### # ##### ######### #
#       #   # # #   # # #               #
##### # ##### # ### # # # ##### ####### #
#     # #     #   #     # #   # #   #   #
# ##### # ####### ####### # # ### # ### #
# #     #   #     #     # # #     #   # #
# # ####### # # ### ### ### ######### # #
# #     # # # #     # # #   #       # # #
# ##### # # ##### ### # # ##### ##### ###
#   #     #     #     # #   #   #   #   #
### # ######### ####### ### # ### # ### #
#   # #   #   #       #       #   # #   #
# # ### # # # ####### # ####### ### # ###
# # #   # # # #       # #       # # #   #
# ### ### # # # ######### ####### # ### #
#       #   #             #             #
#########################################