#########################################
# #   #         #       #               #
# # # ##### ### # ##### # ############# #
#   #     # # #   #   # #       #   #   #
######### # # ##### # # ####### ### # # #
#   #   #   #       # #       #   # # # #
# # ### ######### ### ####### ### # # # #
# #               #     #     # #   # # #
# ############# ####### # ##### ### # ###
#   #           #     # #     #   # #   #
### # ########### ### # ##### # # # ### #
#   # #         # # # #   #   # #     # #
# ### # ####### # # # ##### ### ####### #
#   # #   #   # #   # #   #   # #     # #
### ##### ### # ### # # # ### # # ### # #
#   #   #   # #     #   #   # # # # # # #
# ### # ### # ############# # ### # # # #
#   # #     #   #         # #     #   # #
# # # ####### # ##### ### # ####### ### #
# #           #       #   #             #
#########################################