#########################################
# #   # #       #     #         #       #
# # # # # # ### # # ### ##### ### # ### #
#   # #   # #   # #         # #   # #   #
##### ##### ##### ######### # # ### #####
#   #     #   #     #   #   #   #   #   #
# ####### ### # ##### # ######### ### # #
#       #   # #   #   #     #   #     # #
# ##### ### # ### # ####### # # ####### #
#   # #   # #     # #     #   #   #     #
### # # ### # ##### # ########### # ### #
# #   # #   #   # # #   #       # # #   #
# # ### # ##### # # ### # ### ### # # ###
# # #   #     #   # #   #   #   #   #   #
# # # ####### ### # # # ### ### ####### #
#   #   #   # #   # # # #   # # #       #
# ##### # # # ### # # ### ### # # #######
#     # # # #   # # #   #     #   #     #
##### # # # ### ### # # ##### ##### ### #
#     #   #         # #             #   #
#########################################