#########################################
#   #                 #     #   #       #
### ### # ########### # # # # # # ##### #
# #   # #   #     #   # # #   # # #   # #
# ### # ### ##### # ##### ####### ### # #
#   # #   #     #       # #     # #   # #
### # ####### # ####### # # ### # # # # #
#   # #     # #   #   # # # # #     # # #
# # # # ### # ### # ### # # # ######### #
# # #   # # #   # # #   #       #   #   #
# ####### # ### # # # ##### ##### # # # #
#         # #   # # # #   # #   # # # # #
# ####### # # ### # # # # ### # # # # ###
#     # #   #   # #   # #     #   # #   #
##### # ####### # # ### ########### # # #
#     #       # # # #   # #   #     # # #
# ######### # # # # # ### # # # ####### #
#         # # # # #   #     # #     #   #
######### # # ### ##### ##### ##### # # #
#           #     #         #         # #
#########################################