#########################################
#   #       #     #     #     #         #
### # ### # # # # # ### # # # ####### # #
#   # #   # # # # # # #   # #       # # #
# ##### ### # # ### # ##### ####### # # #
#     # #   # #       #   # #       # # #
##### # # ### ######### # # # ######### #
#     # # #         #   # # # #       # #
# ##### # ######### # ### # # # # ### # #
# #     #     # #   # # #   # # #   # # #
# # ######### # # ### # ##### # ### # # #
#   #   #   # #   # # #     # #   # #   #
##### # # # # # ### # # # ### ##### #####
#   # #   #   # #   # # #   #     #     #
# # # ######### # ### # ### ##### # ### #
# #   #   #   # #   # #   #     # #   # #
# ##### # # ### ### # ### ### ### ##### #
#   #   # #         #   #   #   #     # #
### ### # ############# ### ### ##### # #
#       #               #     #         #
#########################################