###################################################
# #   #           #   #         #     #           #
# # # ######### # # # ##### # # # # ### ##### ### #
#   #       #   #   #     # # # # # #       # #   #
########### # ########### # # # # # # ##### # #####
#         # #     #     # # # # # #   #   # #     #
# ####### # ##### # # # # ### # ####### # ####### #
#   #     # #     # # # #   # # #       #     #   #
# ### ### # # ##### # ##### # # # ########### # # #
# #   #   #   #   # #     #   # # #       # #   # #
### ############# # ##### ##### # # ### # # ##### #
#   #             # #   #     #   #   # #   #   # #
# ### ######### # # # # ##### ####### # ### # # # #
#     # #       # #   #     # #   #   #   # # # # #
# ##### # ### ############# # # # # ##### ### # # #
# #     #   # #     #       #   # #   # #   # # # #
# # ### ### ### ### # ########### ### # ### # # # #
#   #   # #     # # # #   #     # #   #   # # # # #
##### ### ####### # # # ### ### # # ##### # # # # #
#   # #   #       #   # #   #     # #     #   #   #
# # # # # ##### ####### # ######### # # # #########
# # #   #     #       # #     #     # # # #       #
# # ######### ### ### # ##### # ##### # # ### # ###
# # #       # #   #   #   #   #     # # #   # #   #
# # # # ##### # ##### ### # # ##### # # ### # ### #
# # # #     # #     #     # #     # # # #   #   # #
# ### ##### # ##### ### ### ##### # ### # ####### #
#   #     #   #     # # #   #     #   # # #       #
# # ##### ##### ##### # # ########### # # # ##### #
# #             #       #               #   #     #
###################################################