###################################################
#       #           #         #     #         #   #
####### # ######### ##### ### ### # ### ##### ### #
#     # #         #       #   #   # #   #   #     #
# ##### # ####### ######### ### ### # ### # ##### #
#       # #   #   #       # #   #   #   # # #   # #
# ####### # # # ##### ### # # # # ##### # # # # # #
#     #   # # #     #   #   # # #       # # # #   #
##### # ### # ##### ### ####### ######### ### #####
#     # # # #     #   # #     # #       #   #   # #
# ##### # # # ####### # ### # # ### ### # # ### # #
# #   # #   #       # #     # #   # #   # #   # # #
# # # # # ######### # ####### # # # # ### # # # # #
# # #   #   #       # #       # # # #     # # #   #
# # ######### # ##### # ####### # # ####### ##### #
# #           # #     # # #     # #       #   #   #
# ####### ####### ##### # # ##### ######### # # ###
#       # #   #   #     # # #   #         # #     #
####### # # # # ### ##### # ### ######### ####### #
#   #   # # #   #   #     #       # #   #     #   #
### # ##### ##### ####### ####### # # # ##### #####
#   # #     #   #       #       #   # # #   #     #
# ### # ##### ######### # ##### ### # # # # ### # #
#     #     #           #     #     # #   #   # # #
# ######### ### ##################### ####### ### #
#   #     #   # #               #   #   #   # #   #
### # ### ### # ### ########### # # ### # ### # ###
# #   #   #   #     #         #   #   # #     #   #
# ##### ### ######### ### ########### # # ####### #
#           #           #               #         #
###################################################