###################################################
# # #     #   #           #             #     #   #
# # # # # # ### ####### # # ############# # # # # #
# # # # #   #   #   #   # #     #         # #   # #
# # # # ##### ##### # ### ##### # ######### ##### #
# #   #     #     # # #         # #       # #     #
# # ####### ##### # # ######### # # ####### # #####
# #   #   #     #   #   #   #   #   #       # #   #
# ##### # ##### ### ### # # ####### # ####### # ###
# #     #         #   #   #         # #       #   #
# # ##### ########### ####### ####### ####### ### #
# #   #   #         #   #   #   #   #       #   # #
# # # ##### ####### ### # # ##### # ##### # ### # #
# # # #   # #     #     # # #     #     # #   # # #
# # # # # # # ### ####### # # ######### ##### # # #
# # # # # #   # #       # # #   #     #       #   #
# ### # # ##### ##### ### # ### # ### ########### #
#   #   #             #   #     #   #     #   #   #
### # ################# ######### # ####### # # ###
#   #     #   #     #   #       # #     #   # # # #
# ####### # # ##### # ### ##### # ##### # ### # # #
# #   # #   #       # #   #   # # #   # # # # # # #
# # # # ##### ####### ### # # # ### # # # # # # # #
#   # #   #   #     #   #   # #     #   # # #   # #
##### # ### ### ### # # # ### ### ##### # # ##### #
# #   #     #   #   # # # # #   # #   # # #       #
# # ##### ### ### ##### # # ### ### # ### ####### #
# #     #   # # #     # # # #   #   #   #   #   # #
# ##### ##### # ##### # # # # ### ##### ### # # # #
#             #         #   #         #       #   #
###################################################