###################################################
#   #             #     #     #     #         #   #
### # ####### ### # ### # ### ### # # ### ### ### #
#   # #     #   #   # # # # #   # # # # # #     # #
# ### # # # ### ##### # # # ### # # # # # ##### # #
#   # # # #   #     # # # #       # # # #     #   #
### # # # ### ##### # # # ######### # # ##### ### #
#   # # #   #   #   #   # #     #   #       # #   #
# ### ##### ##### ### ### # ### # ######### # #####
# #   #     #   # # #   #     # # #     #   #     #
# # ### ##### # # # ### # ##### # # ### ######### #
# #   #   #   #   # #   # # #   #   # #         # #
# ### ### # ####### # ### # # ####### ######### # #
#   #     #     #   #   # # # #             # #   #
### ##### ##### # # ### # # # # ####### ### # ### #
# # #   #   #   # #     #   # #       #   #   #   #
# # ### ### # ### ######### # ####### ### # ### ###
# #   #     # # #     #   # #     # # # # # #   # #
# ### ####### # ##### # # # ##### # # # # ### ### #
#   #     #   # #   # # #   # #   #   # #   #   # #
# # ##### # ### # # # # ##### # ##### # ### ### # #
# # #   #   #   # #   #     # #     #     #   # # #
# # # # ##### # # ######### # ##### ##### ### # # #
# # # #       # # #           #     #   # #   # # #
# ### ### ##### # ####### ##### ##### # # # ### # #
# #   # # #     #       # #   #   #   #   # #   # #
# # ### # # ########### ### # ### # ####### # ### #
#   #   # #   #   #     #   # #   #   #   # #     #
# ##### # ##### # # ##### ### # ##### ### # ##### #
#       #       #         #     #         #       #
###################################################