###################################################
# #                 #           #           #     #
# ########### ##### # ######### # ####### ### ### #
# #           #   #   #       # #   #   #       # #
# # ########### # ##### ####### ##### # ######### #
#   # #   #     #       #     # #     #         # #
##### # # # # ########### ### # # ##### ####### # #
#     # #   # #   #       # #   #   #   #   #   # #
# ### # ##### # # # ####### ####### ##### # ### # #
#   # # #   #   # #   #   #       #       #   # # #
# # ### # ####### ### # # ### ### ##### ##### # # #
# #   # # #     #   #   #   #   #     # #   # # # #
# ### # # # ### ### ####### # # ##### ### # # # # #
#   #     # # # #   #       # #   #   #   #   # # #
########### # # # # # ########### ### # ####### # #
#   #     # # # # # # #         #   # # #     #   #
# # # ### # # # # # # ### ##### ### # # # ### #####
# # # # #   #     # #   #   # # #   # #   # #     #
# # # # ##### ##### ### ### # # # ### ### # ##### #
# #   #   #   #   #   #     # # #   #   # #     # #
# ##### # # ### # ### ####### # ### ### # # ### # #
#     # #   #   # # # #       #     #   #   #   # #
# ### # ##### ### # # # ### ######### ####### ### #
#   # # #       # #     #   #     #   #   #   #   #
### # ### ####### # ######### ### # ### # # ### # #
#   # #   #   #   #   #     # # #   #   #     # # #
# ### # ### ### ##### # ### # # ##### ######### # #
# #   #   # #   #   # # # #   #   #       #   # # #
# # ##### # # ### # ### # ##### # ######### # # # #
# #         #     #             #           #   # #
###################################################